3000500401
0000001000
5010000000
0000000001
5020000000
0000000000
0200000000
4010000204
0300404020
4040000202