0204000401
0000103002
0100000200
0100105010
0000000000
0508006006
0000000000
0200003020
0105002103
0000000000