0030040040
0000000100
0200100031
0000000000
0030200010
0400050705
0002001000
0000000200
0000003004
0203020302