2020013371
0001030303
4080201000
0002060300
3050202004
0205040200
3030100003
0003020000
0010200403
2004030020