0010005003
0300010020
0010300000
0000000000
0500606050
0020000001
0000000001
0330400020
0000004020
0110400003
