0000000000
0200500021
0000000000
1130605003
0000000012
0020000000
0000002040
5000603003
0000000020
4002203002