0000000000
0300004403
0020300000
0302000200
0100407004
0210000000
0000006043
0020200000
0000000020
0400005012