0305050040
0000202001
0003000000
0000400000
0000004043
0002000000
0300500010
0000003020
0020420003
0304000002