0000000000
2040006002
0000000000
5050404303
0000010000
0000200200
0020040006
5000050010
0000000204
2200050001