00000003022
00020030000
02000004006
00002000000
00000001000
03024060005
00000000010
00000000000
00001000002
00000030020