0000000000
0120200301
0000000002
0010000000
0200410400
0301000000
0030600606
0000001000
0020000002
0400503201