0000000000
0206004020
0000021203
0206000000
0000005004
0204050000
0000004020
0020070002
0300200000
0020050010