0020300302
0000010303
0000000000
0000201100
0050004004
0002020000
0000000404
0000010020
0003003200
0030000031