202000000
000000000
103000030
000000000
000010050
000000000
003000040
000000000
000000000